111111111111111111111
1N000000000000C000CN1
1NC0000N1P00C100C0N01
100000000000NE00000N1
111111111111111111111