1111111111111111111111111111111111
1001001000100000C000111000C0000001
101N01001000101C0C0100100000001011
1010010100C00000101000C00000010111
1010N100100010100010010000C0010101
101001E00000001010100100C000010101
1010010010101010001001000000010101
1C0000C000000000000001000000000001
1010010100000000001100100C00001011
1010010010001010001001000C0C010101
101001001000101C0C010010C00C00C001
1010010100C000N0101000C00000010111
101001001000101C0C0100100000N00001
1010010100C00000101000C00P00000101
1111111111111111111111111111111111