1111111111111111111111
1000000000C0C0C0C11111
1000000000000000000001
10000000E0000P00000001
1111111111111111111111