1111111111111111
1CCCCCCCCCCCPE11
1111111111111111