111111111111111111111111
1000C0N00000C0N000000001
1N000C000C0000000000N001
100N0C0PN000NC0N0E0C0N01
111111111111111111111111