1111111111111111111111
10CCC1PCCCCCCCCC0E0011
10C1C0000000000000C111
10C1CCCCCCCCCCC0000C11
10C1CCC1CCCCCCCC111C11
10C1C11CCCCCCCC1111C11
10C1C111CCCCCCCC111C11
10C1C111111C1111111C11
1111111111111111111111