111111111111111
1010C10Y00000C1
101C0C011111001
101P0C11EC0CY01
111111111111111