111111111111111
101NC1N00N00CN1
101C0C000001001
101P0C1NEC0CN01
111111111111111