111111111111111
10NC01N00000CN1
1N00C0000010001
100P0C1NEC0CN01
111111111111111