1111111111111111111111
100001P0000000000E0011
1001000000000000000111
10010000000CCCCCCCC011
1001000100000000111011
10010110CCCCCCC1111011
1001011100000000111011
1001011111101111111011
1111111111111111111111